"a" = (/turf/template_noop,/area/template_noop)
"b" = (/turf/closed/wall/mineral/iron,/area/shuttle/arrival)
"c" = (/obj/machinery/door/airlock/hatch{name = "Shuttle Airlock"},/turf/open/floor/plating,/area/shuttle/arrival)
"d" = (/obj/machinery/vending/coffee,/turf/open/floor/wood,/area/shuttle/arrival)
"e" = (/turf/open/floor/wood,/area/shuttle/arrival)
"f" = (/turf/open/floor/wood{icon_state = "wood-broken3"},/area/shuttle/arrival)
"g" = (/turf/open/floor/wood{icon_state = "wood-broken7"},/area/shuttle/arrival)
"h" = (/obj/machinery/light{dir = 8},/turf/open/floor/wood,/area/shuttle/arrival)
"i" = (/turf/open/floor/wood{icon_state = "wood-broken6"},/area/shuttle/arrival)
"j" = (/obj/effect/spawner/structure/window/reinforced,/turf/open/floor/plating,/area/shuttle/arrival)
"k" = (/obj/machinery/requests_console{department = "Arrival shuttle"; name = "Arrivals Shuttle console"; pixel_y = 30},/turf/open/floor/wood{icon_state = "wood-broken6"},/area/shuttle/arrival)
"l" = (/obj/machinery/vending/sustenance,/turf/open/floor/wood,/area/shuttle/arrival)
"m" = (/obj/structure/shuttle/engine/heater{dir = 4},/obj/structure/window/reinforced{dir = 8},/turf/open/floor/plating/airless,/area/shuttle/arrival)
"n" = (/obj/structure/shuttle/engine/propulsion/burst/right{dir = 4},/turf/open/floor/plating/airless,/area/shuttle/arrival)
"o" = (/obj/machinery/vending/cigarette,/turf/open/floor/wood,/area/shuttle/arrival)
"p" = (/obj/effect/decal/cleanable/vomit,/turf/open/floor/wood,/area/shuttle/arrival)
"q" = (/turf/open/floor/wood{icon_state = "wood-broken"},/area/shuttle/arrival)
"r" = (/obj/structure/shuttle/engine/propulsion{dir = 4},/obj/docking_port/mobile/arrivals,/turf/open/floor/plasteel/stairs,/area/shuttle/arrival)
"s" = (/obj/structure/shuttle/engine/propulsion{dir = 4},/turf/open/floor/plating/airless,/area/shuttle/arrival)
"t" = (/obj/structure/table,/obj/item/storage/firstaid/regular,/turf/open/floor/wood,/area/shuttle/arrival)
"u" = (/obj/effect/decal/cleanable/blood/old,/turf/open/floor/carpet,/area/shuttle/arrival)
"v" = (/obj/structure/table,/obj/item/storage/toolbox/emergency,/turf/open/floor/wood,/area/shuttle/arrival)
"w" = (/obj/structure/chair/comfy/shuttle{dir = 8},/turf/open/floor/carpet,/area/shuttle/arrival)
"x" = (/obj/effect/decal/cleanable/poopdirt,/turf/open/floor/carpet,/area/shuttle/arrival)
"y" = (/obj/item/radio/intercom{name = "Station Intercom (General)"; pixel_y = -29},/obj/machinery/light,/turf/open/floor/wood,/area/shuttle/arrival)
"z" = (/turf/open/floor/carpet,/area/shuttle/arrival)
"A" = (/obj/structure/shuttle/engine/propulsion/burst/left{dir = 4},/turf/open/floor/plating/airless,/area/shuttle/arrival)
"B" = (/obj/effect/decal/cleanable/vomit,/turf/open/floor/carpet,/area/shuttle/arrival)
"C" = (/obj/structure/table,/obj/item/reagent_containers/food/snacks/soup/tomato,/obj/item/reagent_containers/food/snacks/soup/meatball{pixel_y = 10},/obj/machinery/light/small,/turf/open/floor/wood,/area/shuttle/arrival)
"D" = (/obj/machinery/light,/obj/effect/decal/cleanable/vomit,/turf/open/floor/wood,/area/shuttle/arrival)
"E" = (/obj/effect/decal/cleanable/blood/old,/turf/open/floor/wood,/area/shuttle/arrival)

(1,1,1) = {"
aaabbbjjjjjjbbb
jjbbhfeeegeekmn
jdloepuwxwzwzms
jeqeeezwzwBwzmr
jtCveexwzwzwzms
jjbbefDeeieyEmA
aaabbcbbjjbbcbb
"}
